00000000000000000000000000XXXXXXXXXX
0000000000000000000000000XXXXXXXXXXX
000000000000000000000000XXXXXXXXXXXX
00000000000000000000000XXXXXXXXXXXXX
0000000000000000000000XXXXXXXXXXXXXX
000000000000000000000XXXXXXXXXXXXXXX
00000000000000000000XXXXXXXXXXXXXXXX
0000000000000000000XXXXXXXXXXXXXXXXX
0000000000C0000000XXXXXXXXXXXXXXXXXX
X000C00E00X000000XXXXXXXXXXXXXXXXXXX
XXXXXXXXXXXXXXXXXXXXXXXXXXXXXXXXXXXX