00000000000000000000000000000000000000000000000000000000000000000000000000000
000000000000000000000000X000000000000000000X00000000000000000000X000000000000
0000000000000000000000000000000000X000000000000000000000000000000000000X00000
00000000000000000000X0000000000000000000000000000000000000X000000000000000000
00000000000000000X000000000000000000000000000000X0000000000000000000000000000
0000000000000000000000X000000000000000X0000000000000000X0000000000X0000000000
000000000000000000000000000000X00000000000000000000X000000000X00000000X000000
00000000000000000000000000000000000000000000000000000000000000000000000000000
0000000B000000000000000000000000000000000000000000000000000000000000000000000
XXXXXXXXXXXXXXXXXXXXXXXXXXXXXXXXXXXXXXXXXXXXXXXXXXXXXXXXXXXXXXXXXXXXXXXXXXXXX